"              ####"
"               ###"
"               ###"
"               ###"
"               ###"
"               ###"
"               ###"
"               ###"
"               ###"
"               ###"
"               ###"
"               ###"
"              K###"
"             #####"
"               ###"
"               ###"
"               ###"
"               ###"
"              K###"
"             #####"
"                  "
"           CH     "
"           CH     "
"           CH     "
"           CH     "
"                  "
"              ####"
"               ###"
"              K###"
"             #####"
"               ###"
"               ###"
"              K###"
"               ###"
"               ###"
"             #####"
"               ###"
"               ###"
"               ###"
"               ###"
"              C###"
"              C###"
"              C###"
"              C###"
"               ###"
"               ###"
"               ###"
"           H   ###"
"       CH P!   ###"
"           H   ###"
"               ###"
"               ###"
"               ###"
"               ###"
"              C###"
"              C###"
"              C###"
"              C###"
"               ###"
"             F####"
"               ###"
"               ###"
"               ###"
"|||||||||||||||###"