"              ####"
"               ###"
"               ###"
"               ###"
"               ###"
"               ###"
"               ###"
"               ###"
"               ###"
"              K###"
"               ###"
"               ###"
"              K###"
"             #####"
"               ###"
"               ###"
"               ###"
"               ###"
"              K###"
"             #####"
"                  "
"           CH     "
"        CH CH     "
"        CH CH     "
"           CH     "
"                  "
"              ####"
"               ###"
"              K###"
"            F#####"
"               ###"
"               ###"
"               ###"
"              C###"
"              C###"
"              C###"
"              C###"
"              C###"
"               ###"
"               ###"
"               ###"
"               ###"
"               ###"
"               ###"
"               ###"
"              ####"
"              K###"
"               ###"
"           H   ###"
"       CH P!   ###"
"           H   ###"
"               ###"
"               ###"
"             F####"
"               ###"
"               ###"
"               ###"
"               ###"
"               ###"
"             F####"
"               ###"
"               ###"
"              H   "
"             H    "
"            H     "
"           H      "
"       C  H       "
"                  "
"                  "
"               ###"
"                  "
"               ###"
"                  "
"            F#####"
"               ###"
"            H  ###"
"        CH  H  ###"
"        P!  H  ###"
"            H  ###"
"               ###"
"              C###"
"              C###"
"              C###"
"              C###"
"                  "
"           CH     "
"           CH     "
"           CH     "
"           CH     "
"                  "
"               ###"
"               ###"
"               ###"
"             #####"
"               ###"
"               ###"
"              K###"
"               ###"
"               ###"
"             #####"
"               ###"
"               ###"
"               ###"
"               ###"
"              C###"
"              C###"
"              C###"
"              C###"
"               ###"
"               ###"
"               ###"
"           H   ###"
"        CHP!   ###"
"           H   ###"
"               ###"
"               ###"
"               ###"
"               ###"
"              C###"
"              C###"
"              C###"
"              C###"
"               ###"
"             F####"
"               ###"
"               ###"
"               ###"
"               ###"
"               ###"
"             C####"
"            C#####"
"           C######"
"          C#######"
"         C########"
"         #########"
"               ###"
"               ###"
"              K###"
"               ###"
"               ###"
"           F######"
"               ###"
"               ###"
"               ###"
"               ###"
"              K###"
"               ###"
"               ###"
"               ###"
"              ####"
"           H      "
"       P! CH      "
"          CH      "
"           H      "
"        H         "
"        H         "
"        H         "
"        H         "
"        H         "
"                  "
"            H     "
"                  "
"                  "
"              ####"
"               ###"
"              K###"
"               ###"
"               ###"
"               ###"
"              ####"
"           CH     "
"           CH     "
"           CH     "
"           CH     "
"           CH     "
"                  "
"               ###"
"               ###"
"               ###"
"            F#####"
"               ###"
"          H    ###
"          H   K###"
"          H    ###"
"               ###"
"            F#####"
"               ###"
"               ###"
"               ###"
"               ###"
"              C###"
"              C###"
"              C###"
"               ###"
"              ####"
"               ###"
"               ###"
"              K###"
"             F####"
"               ###"
"              C###"
"               ###"
"                  "
"                  "
"              ####"
"               ###"
"               ###"
"               ###"
"              K###"
"               ###"
"               ###"
"           F######"
"               ###"
"               ###"
"               ###"
"               ###"
"              K###"
"              ####"
"                  "
"               ###"
"               ###"
"               ###"
"               ###"
"               ###"
"               ###"
"               ###"
"               ###"
"              ####"
"            F#####"
"           F######"
"           #######"
"                  "
"          ########"
"                  "
"         #########"
"                  "
"        ##########"
"               ###"
"               ###"
"||||||||||||||####"